bookid                                          		主键  
paixu		排序 
CASno		CAS编号 
bookname		产品名称 
enbookname		英文名称 
ordernum		订单号码 
fapiaonum		发票号码 
krname		客户名称 
date1		订购日期 
date2		订单交货日期 
cjsl		成交数量 
style		成交币种 
price1		工厂价格 
price2		给客人价格 
ysfs		运输方式 
ysfy		运费 
hl		汇率 
zsh		总收汇 
huokuan		工厂货款 
lirun		利润分析 
yundan		外运单号码 
date3		收汇日期 
cpgg		产品规格要求 
baozhuang		包装要求 
isyp		是否给客人样品 
gyscontact		供应商联系方式 
gysname		供应商名称 
iskucun		是否有样品库存 
kucun		库存数量 
fj1		给客人 
fj2		分析报告 
ywy		业务员 
isjs		业务员结算 
isdh		工厂货物是否已到货 
isfh		是否已经给客人发货 
isfp		是否已经给客人发票 
isfxbg		是否已经给客人分析报告 
zhfrom		账户来源 
ists		是否要退税 
date4		预计收汇日期 
issh		是否收汇 
iskp		工厂是否要开票 
isgcfp		是否收到工厂发票 
mylx		贸易类型 
ishx		是否已经核销 
date5		核销截止日期 
iswcts		是否已经完成退税 
ishkqf		工厂货款是否已经全付 
qgchk		欠工厂部分货款 
krqk		客人欠款部分 
isok		是否完成 
krkpdz		客人开票地址 
krfhdz		客人发货地址 
content		备注
